压缩包密码:1234
注意:插件不可以改名为dm.dll,否则会失效!
如果要在简单游平台使用,那您需要自己去申请审核插件(不要说是大漠插件,就说是自己的插件.否则专员不给你审核的).
定制的版本除了接口和原来插件一样,其他都不一样. 可以认为是一个新插件,只是接口一样而已. 
按键系列平台,使用此版本,只需要把dm.dmsoft替换成新的对象名即可. 
E语言,使用此版本,只需要把dm.dmsoft替换成新的对象名即可. (这是使用对象方式调用的前提,如果是支持库方式,则需要重新导入支持库!)
VB系列平台,使用此版本,只需要把dm.dmsoft替换成新的对象名即可. 
VC系列平台,使用此版本,需要重新导入dll. 如果没有用到tlb方式调用,则直接替换dm.dmsoft为新的对象名即可. 
c#系列平台,使用此版本,需要重新生成类型库.  
其他平台,也基本类似. 
如果要使用免注册方式调用定制版本插件,必须用v6.0之后版本的DmReg.dll
生成版本信息:
用户名:jerome10503
对象名:asd.jkl
加花级别:1
版本类型:普通
线程模型:MTA
自定义函数:
CreateFoobarCustom->ZrVpncXNyy
CreateFoobarEllipse->XgWcZXg
CreateFoobarRect->yyMsCXMNwIyfclZ
CreateFoobarRoundRect->NgKFozDGaYgTZs
FoobarClearText->BbSS
FoobarClose->LqDwDdHj
FoobarDrawLine->oaCe
FoobarDrawPic->mJVzXGRN
FoobarDrawText->kninkazwlpXZ
FoobarFillRect->YMbRyaGf
FoobarLock->VIPbmNZnXec
FoobarPrintText->vKGqsjnSqGA
FoobarSetFont->pBzYzwa
FoobarSetSave->gFCWrxVMakD
FoobarStartGif->BQegdDIFXuMz
FoobarStopGif->FgXkluHV
FoobarTextLineGap->cFmKkoyPjZDoYI
FoobarTextPrintDir->fAlIpgbZw
FoobarTextRect->TJMu
FoobarUnlock->hkBYGDYvbjC
FoobarUpdate->DZRKCyJTddJaeE
FoobarSetTrans->EnKtm
ClientToScreen->ArdSDJYj
EnumProcess->qwacjzR
EnumWindow->sSgnPmt
EnumWindowByProcess->uFbNwxl
EnumWindowByProcessId->xjdBw
EnumWindowSuper->uMTXAP
FindWindow->QQNpTWXLm
FindWindowByProcess->BNRK
FindWindowByProcessId->qCHliTqBhIczP
FindWindowEx->KPdzGffJP
FindWindowSuper->KnEb
GetClientRect->HBQVxAlJQETcn
GetClientSize->DJHTEevEJgUTsjB
GetForegroundFocus->HsCKVCBQtyUmhJe
GetForegroundWindow->aIpd
GetMousePointWindow->bpbGiyCFhGn
GetPointWindow->yewBVFlax
GetProcessInfo->AocJGoZQhhr
GetSpecialWindow->JqQpzgphspinsg
GetWindow->pmvfxUonRM
GetWindowClass->dngdlxzkrzqxg
GetWindowProcessId->xnHx
GetWindowProcessPath->HYmUhNCjHwHGqo
GetWindowRect->ZbXIYI
GetWindowState->LjIdu
GetWindowTitle->eMXkN
MoveWindow->RkWLnjEkkagqlSi
ScreenToClient->fuutoIBtYlWaaw
SendPaste->jJrFRzABKcxI
SendString->yeVnBbhmBY
SendString2->CUuqYNYWamL
SendStringIme->CIXmYhPPkymZ
SendStringIme2->BksCXsPhGo
SetClientSize->bPTc
SetWindowSize->LNnuLIz
SetWindowState->MKHeEjypKiH
SetWindowText->ggIVD
SetWindowTransparent->yWVPA
FaqCancel->vqNx
FaqCapture->cSvYpUIQCTE
FaqCaptureFromFile->toimToJJtrciF
FaqFetch->HeavDDb
FaqGetSize->WQXnz
FaqPost->kgmPQpksvWTCl
FaqSend->SxnoeQADkkguFLQ
FaqIsPosted->koFWJ
DmGuard->LDjanCFoCTl
BindWindow->dQXitltFDJJkBab
BindWindowEx->MewiqSjbm
DownCpu->TtuSLeKvDPT
EnableBind->UuKmCafHCoE
EnableFakeActive->lyGmWGJUjCCboIn
EnableIme->lBywXXxjl
EnableKeypadMsg->HoaBvUD
EnableKeypadPatch->INDvJeuS
EnableKeypadSync->BdwLFIPZ
EnableMouseMsg->kpgWjvqLGRTWj
EnableMouseSync->ofBAHHQCoroQK
EnableRealKeypad->ZloXjW
EnableRealMouse->iQdXrnKEAj
EnableSpeedDx->uVSk
ForceUnBindWindow->skRvwFgWa
GetBindWindow->tgPYNwmtwMkoDW
IsBind->IWEbYaWnPxiJM
LockDisplay->gziyzrIbPunz
LockInput->AqpJ
LockMouseRect->Gfqv
SetDisplayDelay->gzQaN
SwitchBindWindow->aJzmoSRJu
UnBindWindow->UrkFsiL
SetAero->okPzqf
AsmAdd->cxYZMtcydNNAy
AsmCall->PHZtoyKfGSXPoP
AsmClear->TKcEQZE
AsmCode->eannMXlEeaSYe
Assemble->JVQMHMalaZCTc
GetBasePath->YYrxxZfpvknBa
GetDmCount->rjMufpVxXpj
GetID->hJcwdWimR
GetLastError->GAWNmmwEnM
GetPath->DQQuUFzGq
Reg->RgoRSUZbo
RegEx->erQYI
RegExNoMac->TkaxowFqVZPiEPn
RegNoMac->bqlrLjlCC
SetDisplayInput->ZFGoUHEMt
SetEnumWindowDelay->WVnWSbJdIWmq
SetPath->gWRPskESyjHDxFc
SetShowErrorMsg->DRos
Ver->VjJECut
EnablePicCache->DJzKeSIagaWZRQ
GetCursorPos->JdBdN
GetCursorShape->Gycp
GetCursorShapeEx->oNzTghfqb
GetCursorSpot->kMUlsQMqkseKks
GetKeyState->dIbko
KeyDown->KTnnwLYkGywx
KeyDownChar->jGqxJaB
KeyPress->HaFAj
KeyPressChar->YlwYJkSNfuD
KeyPressStr->ocPEnHFrxRxFPQI
KeyUp->gFTfSTA
KeyUpChar->voGGoBCHAWm
LeftClick->mYSFeGxQBj
LeftDoubleClick->sNLYpZtGdm
LeftDown->gSsWz
LeftUp->YPSrzhdTfbVZ
MiddleClick->kziVYNSwEClF
MoveR->Yybw
MoveTo->flEflWkBg
MoveToEx->YloXjnQHJt
RightClick->XvkNmMIfEK
RightDown->SnKC
RightUp->TJjZXSyrPxB
SetKeypadDelay->yYNhBj
SetMouseDelay->jhAJUKEYghDC
SetSimMode->TNzXslEVhw
WaitKey->XsvDuL
WheelDown->NDqN
WheelUp->bTsfst
DoubleToData->nFzve
FindData->iTqzAKQQ
FindDataEx->FsVWWpe
FindDouble->YEmURUIHah
FindDoubleEx->zHLprgNZZ
FindFloat->jGEhLeWBwX
FindFloatEx->LBlvbStHi
FindInt->StJdVUxhCT
FindIntEx->hJrYRpvuTfpy
FindString->ncfXD
FindStringEx->iWyTjARBGwoEWI
FloatToData->SgqB
FreeProcessMemory->gsVGok
GetCommandLine->AVpQSMXRb
GetModuleBaseAddr->RwudDAfcsxkAk
IntToData->WuBw
OpenProcess->BbuQhJbVEQ
ReadData->klCBimrLRPvis
ReadDataAddr->bBGnLtXVPL
ReadDouble->pLArs
ReadDoubleAddr->HLzHbkRpLo
ReadFloat->paqGP
ReadFloatAddr->NYbEtGyxq
ReadInt->BMjCGXo
ReadIntAddr->skXItoVtuPMkth
ReadString->akJgUF
ReadStringAddr->bbYltGlRQ
SetMemoryFindResultToFile->aAvy
SetMemoryHwndAsProcessId->gcBlmfyVJpAIIf
StringToData->SUAHCX
TerminateProcess->vtuQESxINqFq
VirtualAllocEx->gEEBtoqsWFcJ
VirtualFreeEx->gRScjYG
WriteData->fktHFbWRUbKz
WriteDataAddr->DddwuZIGTCyQWhI
WriteDouble->lGiAFwePmNpY
WriteDoubleAddr->bKoXKNafMo
WriteFloat->mihXj
WriteFloatAddr->WuTVyvyIW
WriteInt->jTEWW
WriteIntAddr->PFjkRzKbbFMBTIm
WriteString->riARGuKxXrQLs
WriteStringAddr->lZJxfIQTXANP
ExcludePos->EpvXeCEybzN
FindNearestPos->kvdqJWs
SortPosDistance->bQetQJDmGKT
AppendPicAddr->BYnG
BGR2RGB->GspF
Capture->nImPlWyAXDwyuq
CaptureGif->RhIhRHXCw
CaptureJpg->bclytRCG
CapturePng->jeJgDS
CapturePre->UxFyiBtJZSwWlR
CmpColor->IyzJAIMpuakxrZ
EnableDisplayDebug->JyhANyYfwIEi
EnableGetColorByCapture->aRAKKTFydSb
FindColor->EiUfjccYYgB
FindColorBlock->vyskeWdqhWwieyw
FindColorBlockEx->pqYytUkA
FindColorE->sHbl
FindColorEx->RteQimylfAyvN
FindMulColor->wDusQDyMpIa
FindMultiColor->bQGxAYkD
FindMultiColorE->DnvmCIAhgCVC
FindMultiColorEx->BsoRpcPAeUBGr
FindPic->PTMFYHcEnsHbpo
FindPicE->UknFrRAjpMlodef
FindPicEx->ofTVIeQNF
FindPicExS->whzwRkUVVJts
FindPicMem->PypdlKTSKCf
FindPicMemE->bWvVc
FindPicMemEx->cLZN
FindPicS->czeA
FindShape->ayiPYReGEP
FindShapeE->BlMhbRQsuF
FindShapeEx->yFJtzEEfJAZSAL
FreePic->hefBEhDwvlrt
GetAveHSV->SpGU
GetAveRGB->cVeh
GetColor->cfGD
GetColorBGR->yqUowNckaJx
GetColorHSV->ZldGUJiD
GetColorNum->QYPeS
GetPicSize->ewTrtdknvRkUN
GetScreenData->iiQgWC
GetScreenDataBmp->jnwHhoXcjc
ImageToBmp->pZXkXzsLCfu
IsDisplayDead->duwxpyPG
LoadPic->zGbhjgVywBTCJb
MatchPicName->PRkp
RGB2BGR->eMSwrEQjeY
SetPicPwd->IpJhSsWy
LoadPicByte->JRMEmwUWqkocj
CopyFile->TCphZLL
CreateFolder->sUVg
DecodeFile->SBFXmTpYKBGImYh
DeleteFile->svMv
DeleteFolder->zYSnBTWTAWpN
DeleteIni->vXaQHifjL
DeleteIniPwd->ZvTbSAdxziS
DownloadFile->ehAGmM
EncodeFile->BVXAoZlAkhYmg
EnumIniKey->RSaESoRuxp
EnumIniKeyPwd->jotEAYcGD
EnumIniSection->fCVB
EnumIniSectionPwd->ltUrfzAZkTqMCa
GetFileLength->cMWYgS
IsFileExist->fsXl
MoveFile->iBsKCTKUNCnLZsm
ReadFile->wCtcar
ReadIni->MdIpgcovHqkt
ReadIniPwd->JhIDaAEZEIZJU
SelectDirectory->eChn
SelectFile->oYBXlZqLpJW
WriteFile->TqIbujtiy
WriteIni->lETxLf
WriteIniPwd->XHyiWX
AddDict->aJPNmW
ClearDict->DsuymrrvRY
FetchWord->UcWnYV
FindStr->wPpQkVZcjpDdMTK
FindStrE->jEgs
FindStrEx->xECiRSmyF
FindStrExS->qGnDiMnkMKizo
FindStrFast->tEeLE
FindStrFastE->ZJowmr
FindStrFastEx->MqxUJgQFjDXA
FindStrFastExS->gfcUWYcv
FindStrFastS->pUPu
FindStrS->rYJuqa
FindStrWithFont->ygFcIJnRo
FindStrWithFontE->HDedvsrEq
FindStrWithFontEx->WIvDUMgPlkmBX
GetDict->qjbWRVNdHyvwM
GetDictCount->uehGap
GetDictInfo->wkMBTYjA
GetNowDict->rrthmtpK
GetResultCount->NXcHLeBrntnSvII
GetResultPos->DVpT
GetWordResultCount->Ivdk
GetWordResultPos->kTjhthEtRnW
GetWordResultStr->fkBlNM
GetWords->twqGghzp
GetWordsNoDict->NXBnerfhXuDRG
Ocr->TwfNanHCBnPjb
OcrEx->MUmHUDZPg
OcrExOne->bjLqwgygsWJRl
OcrInFile->MawgaXaT
SaveDict->AfGLqcUZUp
SetColGapNoDict->xYWWjzTUaWAm
SetDict->nRToSIS
SetDictMem->FHCSaX
SetDictPwd->IEkHbvFu
SetExactOcr->LLXpA
SetMinColGap->UgkHuZvh
SetMinRowGap->pCCeBkjKWjd
SetRowGapNoDict->efGzxqk
SetWordGap->NDQE
SetWordGapNoDict->aTqYIfcj
SetWordLineHeight->bYIEdaciK
SetWordLineHeightNoDict->iFXFvvEMb
UseDict->YawJMVR
Beep->KXiRuSlfsC
CheckFontSmooth->vvqeBX
CheckUAC->KbQNSR
Delay->ZqCcucyBXy
Delays->PTbVRmNZCafJi
DisableFontSmooth->oNjkQtJEbdZUcRY
DisablePowerSave->tpjaPcr
DisableScreenSave->aaCfyNWvDyBwKU
ExitOs->XMfL
GetClipboard->fxcmlMq
GetDir->odMp
GetDiskSerial->SVZZaYFWuUDmbm
GetDisplayInfo->pzQWACsFenBhL
GetMachineCode->bCjCMzlUwxQB
GetMachineCodeNoMac->bTdySiRJuU
GetNetTime->ZAgBBstqtgFCqX
GetNetTimeByIp->hZhi
GetNetTimeSafe->EbnaYwNNl
GetOsType->AxTqJuTrfCongn
GetScreenDepth->rFgzLzRQ
GetScreenHeight->PsTLePxf
GetScreenWidth->cCWlAwuBPyMXiqN
GetTime->cmKEpGiCn
Is64Bit->SiFD
Play->gRrNcGTT
RunApp->nIrtECJyWEIx
SetClipboard->eXfZksoZQSmzR
SetDisplayAcceler->ydDYoNtnHRNdsA
SetScreen->bsgyDoLUaXatqc
SetUAC->HNiqFBqICgs
Stop->VbwYZQKLVqTCLz
EnableFontSmooth->BKcBnBE
ActiveInputMethod->tRsgtRuS
CheckInputMethod->bdABqCN
EnterCri->MYCJeRHtv
FindInputMethod->sLJLBlQdXAMhPpp
InitCri->EIDAqfZhYqvCS
LeaveCri->GWBpIaLeXI
GetInfo->FFEY
StrStr->KzuslhRgIbZwq
SendCommand->lLYIYFDuMNIlW
ShowScrMsg->WHRnPjeRQXt
FaqRelease->nQDqvDMU
MoveDD->YNegPvDnZIroo
FreeScreenData->SKdDyd
SetEnv->nLdIAUtmfeCqi
GetEnv->usgYmxi
DelEnv->DZWNnkXLtShzr
Log->qScSsoRhGYWI
Md5->FkNPbrYXR
GetMac->NCtQ
SetExportDict->ogxDCkfuH
ReadFileData->dKWvqPTeCow
